######## #########
#......###.......#
#...#..|.|.......#
#......###.......#
######## ####|####
            #.#
            #.#
            #.#
            #.#
            #.#
            #.#
            #.#
#############|#########################
#.....................................#
#.....................................###################
#.....s..h.....................................|........#
#............................####.............###########
#.............................................#
#..@..........d.........R.............#########
#.....................................#
#...####............................#
#.....................................#
#.....................................#
#.....................................#
#.....................................#
#######################################