#################
#......###......#
#......|.|......#
#......###......#
#################